0100010101010000010100000001
1010010010100000010001000000
1010010000100000010101000010
1010010010100000000101000010
1010000010000000010101000010
1010010010100000010101000010
0100010101010000010100000001
1010010010100000010001000000
1010010000100000010101000010
1010010010100000000101000010
1010000010000000010101000010
1010010010100000010101000010
0100010101010000010101111111
1010010010100000010001000000
1010010000100000010101000010
1010010010100000000101000010
1010000010000000010101000010
1010010010100000010101000010
0100010101010000010101000001
1010000010001010101001010001
1010010000100000010101000010
1010010010100000000101000010
1010000010000000010101000010
1010010010100000010101000010
0100010101010000010100000001
1010010010100000010001000000
1010010000100000010101000010
1010010010100000000101000010
1010000010000000010101000010
1010010000100000010101000010
1010010010100000000101000010
0010000010000000010101000010
0111110010100000010101000010
0100010101010000010100000001
1011110010100000010001000000
1010010000100000010101000010
1010010010100000000101000010
1010000010000000010101000010
1310010010100000010101000010
