0100310101010000010100000001
1010010010100000010001000000
1010010000100000010101000010
1010010010100000000101000010
1010000010000000010101000010
1010010010100000010101000010