000030000000000000000000000000000000
111111111111111111111111111100000000
000000000000000000000000000000000000
000000000001111111111111111110000000
000000000001000000000000000000000000
111111111111000000000000000001111111
000000000000000000000000000000000000
111111111111111111111111111111111110
000000000000000000000000000000000000
