010000000000000000000000000000000000
001000000000000000000000000000000000
000000010000000000000000000000000000
000001001000000000000001111111111100
000000101000000000000001000000000100
000000010000000000000001000000000100
000011100000000000000001111000111100
000111100000000000000000000000000000